{
    "tiles": {
      "P": 1, 
      "Ps": 2, 
      "W": 3,
      "C": 4   
    },
    "layers": [
      {
        "data": [
          ["W", "P", "P", "P", "P", "P", "P", "P", "P", "P", "P", "P", "P", "P", "Ps"],
          ["W", " ", " ", " ", " ", " ", " ", " ", " ", " ", " ", " ", " ", " ", "W"],
          ["W", " ", " ", " ", " ", " ", " ", " ", " ", " ", " ", " ", " ", " ", "W"],
          ["W", " ", " ", " ", " ", " ", " ", " ", " ", " ", " ", " ", " ", " ", "W"],
          ["W", "", " ", " ", "C", " ", " ", " ", " ", " ", " ", " ", " ", " ", "W"],
          ["W", " ", " ", " ", " ", " ", " ", " ", " ", " ", " ", " ", " ", " ", "W"],
          ["W", "P", "P", "P", "P", " ", " ", " ", " ", " ", " ", " ", " ", " ", "W"],
          ["W", " ", " ", " ", " ", " ", " ", " ", " ", " ", " ", " ", " ", " ", "W"],
          ["W", " ", " ", " ", " ", " ", " ", " ", " ", " ", " ", " ", " ", " ", "W"],
          ["W", " ", " ", " ", " ", " ", " ", " ", " ", " ", " ", " ", " ", " ", "W"],
          ["W", " ", " ", " ", " ", " ", " ", " ", " ", " ", " ", " ", " ", " ", "W"],
          ["W", " ", " ", " ", " ", " ", " ", " ", " ", " ", " ", " ", " ", " ", "W"],
          ["W", " ", " ", " ", " ", " ", " ", " ", " ", " ", " ", " ", " ", " ", "W"],
          ["W", " ", " ", " ", " ", " ", " ", " ", " ", " ", " ", " ", " ", " ", "W"],
          ["W", "Ps", "Ps", "Ps", "Ps", "Ps", "Ps", "Ps", "Ps", "Ps", "Ps", "Ps", "W"]
        ]
      }
    ]
  }