{
    "tiles": {
      "P": 1, 
      "Ps": 2, 
      "W": 3,
      "C": 4,
      "D": 5
    },
    "layers": [
      {
        "data": [
          ["W", "P", "P", "P", "P", "P", "P", "P", "P", "P", "P", "P", "P", "P", "Ps"],
          ["W", " ", " ", " ", " ", " ", " ", " ", " ", " ", " ", " ", " ", " ", "W"],
          ["W", " ", " ", " ", " ", " ", " ", " ", " ", " ", " ", " ", " ", " ", "W"],
          ["W", " ", " ", " ", " ", " ", " ", " ", " ", "P", "P", "P", " ", " ", "W"],
          ["W", "", " ", " ", " ", " ", " ", " ", " ", " ", " ", "P", " ", " ",  "W"],
          ["W", " ", " ", " ", " ", " ", " ", " ", " ", " ", "P", " ", " ", " ", "W"],
          ["W", "P", "P", "P", " ", " ", " ", " ", " ", "P", " ", " ", "P", " ", "W"],
          ["W", " ", " ", " ", " ", " ", " ", " ", " ", "P", "P", "P", " ", " ", "W"],
          ["W", " ", " ", " ", " ", " ", " ", " ", " ", " ", " ", " ", " ", " ", "W"],
          ["W", " ", " ", " ", " ", " ", " ", " ", " ", " ", " ", " ", " ", " ", "W"],
          ["W", " ", " ", " ", " ", " ", " ", " ", " ", " ", " ", " ", " ", " ", "W"],
          ["W", "P", "P", " ", " ", " ", " ", " ", " ", " ", " ", " ", " ", " ", "W"],
          ["W", " ", " ", " ", " ", " ", " ", " ", " ", " ", " ", " ", "Ps", " ", "W"],
          ["D", " ", " ", " ", " ", " ", " ", " ", " ", " ", " ", " ", " ", " ", "W"],
          ["Ps", "Ps", "Ps", "Ps", "Ps", "Ps", "Ps", "Ps", "Ps", "Ps", "Ps", "Ps", "Ps", "Ps", "W"]
        ]
      }
    ],
    "doors": [
      {
        "x": 0,
        "y": 13,
        "target": "../map/level3.json"
      }
    ]
  }
  