{
    "tiles": {
      "P": 1, 
      "Ps": 2, 
      "W": 3,
      "C": 4,
      "D": 5
    },
    "layers": [
      {
        "data": [
          
            ["W", "P", "P", "P", "P", "P", "P", "P", "P", "P", "P", "P", "P", "P", "Ps"],
            ["W", " ", " ", " ", " ", " ", " ", " ", " ", " ", " ", " ", " ", " ", "W"],
            ["W", " ", " ", " ", " ", " ", " ", "C", " ", " ", " ", " ", " ", " ", "W"],
            ["W", " ", " ", " ", " ", " ", " ", " ", " ", " ", " ", " ", " ", " ", "W"],
            ["W", " ", " ", " ", " ", " ", " ", " ", " ", " ", " ", " ", " ", " ", "W"],
            ["W", " ", " ", " ", " ", " ", " ", " ", " ", " ", " ", " ", " ", " ", "W"],
            ["W", "P", "P", "P", "P", "P", "P", "P", " ", " ", " ", " ", " ", " ", "W"],
            ["W", " ", " ", " ", " ", " ", " ", " ", " ", " ", " ", " ", " ", " ", "W"],
            ["W", " ", " ", " ", " ", " ", " ", " ", " ", " ", " ", " ", " ", " ", "W"],
            ["W", " ", " ", " ", " ", " ", " ", " ", " ", " ", " ", " ", " ", " ", "D"],
            ["W", " ", " ", "P", " ", " ", " ", " ", " ", " ", " ", " ", " ", " ", "Ps"],
            ["W", "P", "P", " ", " ", " ", " ", " ", " ", " ", " ", " ", " ", " ", "W"],
            ["W", " ", " ", " ", " ", " ", " ", " ", " ", " ", " ", " ", " ", " ", "W"],
            ["W", " ", " ", " ", " ", " ", " ", " ", " ", " ", " ", " ", " ", " ", "W"],
            ["W", "Ps", "Ps", "Ps", "Ps", "Ps", "Ps", "Ps", "Ps", "Ps", "Ps", "Ps", "Ps", "Ps", "Ps"]
        ]
      }
    ],
    "doors": [
      {
        "x": 14,
        "y": 9,
        "target": "../map/level4.json"
      }
    ]
  }