{
    "tiles": {
      "P": 1, 
      "Ps": 2, 
      "W": 3,
      "C": 4
    },
    "layers": [
      {
        "data": [
          ["W"," "," "," "," "," "," "," "," "," "," "," "," "," "," "," "," "," ","W"],
          ["W"," "," "," "," "," "," "," "," "," "," "," "," "," "," "," "," "," ","W"],
          ["W"," "," "," "," "," "," "," "," "," "," "," "," "," "," "," "," "," ","W"],
          ["W"," "," "," "," "," "," "," "," "," "," "," "," "," "," "," "," "," ","W"],
          ["W"," "," "," "," "," "," "," "," "," "," "," "," "," "," "," "," "," ","W"],
          ["W"," "," "," "," "," "," "," "," "," "," "," "," "," "," "," "," "," ","W"],
          ["W"," "," "," "," "," "," "," "," "," "," "," "," "," "," "," "," "," ","W"],
          ["W"," "," "," "," "," "," "," "," "," "," "," "," "," "," "," "," "," ","W"],
          ["W"," "," "," "," "," "," "," "," "," "," "," "," "," "," "," "," "," ","W"],
          ["W"," "," "," "," "," ","P"," ","Ps"," ","Ps"," ","Ps"," ","Ps","P","P","P","W"],
          ["W"," "," "," "," ","P","W"," "," "," "," "," "," "," "," ","W"," "," ","W"],
          ["W"," "," "," ","P"," ","W","P"," "," "," "," "," "," "," ","W"," "," ","W"],
          ["W"," "," ","P"," "," ","W"," "," "," "," "," "," "," "," ","W"," "," "," "],
          ["W"," "," "," "," "," ","W"," "," "," "," "," "," "," "," ","W"," "," "," "],
          ["Ps","Ps","Ps","Ps","Ps","Ps","Ps","Ps","Ps","Ps","Ps","Ps","Ps","Ps","Ps","Ps","Ps","Ps"]
        ]
      }
    ],
    "doors": [
      {
        "x": 0,
        "y": 13,
        "target": "../map/level3.json"
      },
      {
        "x": 0,
        "y": 4,
        "target": "../map/level1.json",
        "spawn_x": 12.5,
        "spawn_y": 12.0
      }
    ]
  }
  