{
    "tiles": {
      "P": 1, 
      "Ps": 2, 
      "W": 3,
      "C": 4,
      "D": 5
    },
    "layers": [
      {
        "data": [
          
            ["W", "P", "P", "P", "P", "P", "P", "P", "P", "P", "P", "P", "P", "P", "Ps"],
            ["W", " ", " ", " ", " ", " ", " ", " ", " ", " ", " ", " ", " ", " ", "W"],
            ["W", " ", "C", " ", " ", " ", " ", "C", " ", "C", " ", " ", " ", " ", "W"],
            ["W", " ", " ", "P", " ", " ", " ", " ", " ", " ", "P", " ", " ", " ", "W"],
            ["W", " ", " ", " ", "C", " ", " ", " ", "C", " ", " ", " ", " ", " ", "W"],
            ["W", " ", " ", " ", " ", " ", " ", " ", "P", " ", "P", " ", "P", " ", "W"],
            ["W", "P", "P", "P", "P", "P", "P", "P", "Ps", "Ps", "Ps", "Ps", " ", " ", "W"],
            ["W", " ", " ", " ", " ", " ", " ", " ", " ", " ", " ", " ", "P", " ", "W"],
            ["W", " ", " ", " ", " ", " ", " ", " ", " ", " ", "C", " ", " ", " ", "W"],
            ["W", " ", " ", " ", " ", " ", " ", " ", " ", "P", " ", " ", " ", " ", "W"],
            ["W", " ", " ", "P", "P", " ", " ", " ", " ", "P", " ", " ", " ", " ", "W"],
            ["W", "P", "P", " ", "C", " ", " ", " ", " ", " ", "C", " ", " ", " ", "W"],
            ["W", " ", " ", " ", " ", " ", " ", " ", " ", " ", " ", " ", " ", " ", "W"],
            ["W", " ", " ", " ", " ", " ", " ", " ", " ", " ", " ", " ", " ", " ", "D"],
            ["W", "Ps", "Ps", "Ps", "Ps", "Ps", "Ps", "Ps", "Ps", "Ps", "Ps", "Ps", "Ps", "Ps", "Ps"]
        ]
      }
    ],
    "doors": [
      {
        "x": 14,
        "y": 13,
        "target": "../map/level4.json"
      }
    ]
  }