{
    "tiles": {
      "P": 1, 
      "Ps": 2, 
      "W": 3,
      "C": 4,
      "D": 5
    },
    "layers": [
      {
        "data": [
          ["W"," "," "," "," "," "," "," "," "," "," "," "," "," ","W"],
          ["W"," "," "," "," "," "," "," "," "," "," "," "," "," ","W"],
          ["W"," "," "," "," "," "," "," "," "," "," "," "," "," ","W"],
          ["W"," "," "," "," "," "," "," "," "," "," "," "," "," ","W"],
          ["W"," "," "," "," "," "," "," "," "," "," "," "," "," ","W"],
          ["W"," "," "," "," "," "," "," "," "," "," "," "," "," ","W"],
          ["W"," "," "," "," "," "," "," "," "," "," "," "," "," ","W"],
          ["W"," "," "," "," "," "," "," "," "," "," "," "," "," ","W"],
          ["W"," "," "," "," "," "," "," "," "," "," "," "," "," ","W"],
          ["W"," "," "," "," ","P"," ","Ps","Ps","Ps"," ","Ps","P","P","W"],
          ["W"," "," "," ","P","W"," "," "," "," "," ","W"," "," ","W"],
          ["W"," "," ","P"," ","W","P"," "," "," "," ","W"," "," ","W"],
          ["W"," ","P"," "," ","W"," "," "," "," "," ","W"," "," "," "],
          ["W"," "," "," "," ","W"," "," "," "," "," ","W"," "," "," "],
          ["Ps","Ps","Ps","Ps","Ps","Ps","Ps","Ps","Ps","Ps","Ps","Ps","Ps","Ps","Ps"]
        ]
        
      }
    ],
    "doors": [
      {
        "x": 21,
        "y": 1,
        "target": "../map/level1.json"
      }
    ]
  }