{
    "tiles": {
      "P": 1, 
      "Ps": 2, 
      "W": 3,
      "C": 4
    },
    "player_spawn": {
      "x": 1.5,
      "y": 13.5
    },
    "layers": [
      {
        "data": [
          ["W"," "," "," "," "," "," "," "," "," "," "," "," "," "," "," "," "," ","W"],
          ["W"," "," "," "," "," "," "," "," "," "," "," "," "," "," "," "," "," ","W"],
          ["W"," "," "," "," "," "," "," "," "," "," "," "," "," "," "," "," "," ","W"],
          ["W"," "," "," "," "," "," "," "," "," "," "," "," "," "," "," "," "," ","W"],
          ["W"," "," "," "," "," "," "," "," "," "," "," "," "," "," "," "," "," ","W"],
          ["W"," "," "," "," "," "," "," "," "," "," "," "," "," "," "," "," "," ","W"],
          ["W"," "," "," "," "," "," "," "," "," "," "," "," "," "," "," "," "," ","W"],
          ["W"," "," "," "," "," "," "," "," "," "," "," "," "," "," "," "," "," ","W"],
          ["W"," "," "," "," "," "," "," "," "," "," "," "," "," "," "," "," "," ","W"],
          ["W"," "," "," "," "," ","P"," ","Ps","Ps","Ps"," "," "," "," ","Ps","P","P","W"],
          ["W"," "," "," "," ","P","W"," "," "," "," "," "," "," "," ","W"," "," ","W"],
          ["W"," "," "," ","P"," ","W","P"," "," "," "," "," "," "," ","W"," "," ","W"],
          ["W"," "," ","P"," "," ","W"," "," "," "," "," "," "," "," ","W"," "," "," "],
          ["W"," "," "," "," "," ","W"," "," "," "," "," "," "," "," ","W"," "," "," "],
          ["Ps","Ps","Ps","Ps","Ps","Ps","Ps","Ps","Ps","Ps","Ps","Ps","Ps","Ps","Ps","Ps","Ps","Ps", "Ps"]
      ]
      
      }
    ],
    "doors": [
      {
        "x": 18,
        "y": 12,
        "target": "../map/level2.json",
        "spawn_x": 1.5,
        "spawn_y": 4.5
      }
    ]
  }